,image,id,name,xMin,xMax,yMin,yMax,height,width,x,y,annotations
0,IMG_7009.jpg,1,tip,120,562,1548,1954,406,442,341,1751,"[{'type': 'rectangle', 'coordinates': {'y': 1751.0, 'width': 442.0, 'x': 341.0, 'height': 406.0}, 'label': 'Object'}]"
1,IMG_6868.jpg,1,tip,1161,1552,2560,3073,513,391,1356,2816,"[{'type': 'rectangle', 'coordinates': {'y': 2816.0, 'width': 391.0, 'x': 1356.0, 'height': 513.0}, 'label': 'Object'}]"
2,IMG_6840.jpg,1,tip,880,1191,2220,2667,447,311,1035,2443,"[{'type': 'rectangle', 'coordinates': {'y': 2443.0, 'width': 311.0, 'x': 1035.0, 'height': 447.0}, 'label': 'Object'}]"
3,IMG_6854.jpg,1,tip,1095,1398,1814,2169,355,303,1246,1991,"[{'type': 'rectangle', 'coordinates': {'y': 1991.0, 'width': 303.0, 'x': 1246.0, 'height': 355.0}, 'label': 'Object'}]"
4,IMG_6883.jpg,1,tip,171,665,2330,2770,440,494,418,2550,"[{'type': 'rectangle', 'coordinates': {'y': 2550.0, 'width': 494.0, 'x': 418.0, 'height': 440.0}, 'label': 'Object'}]"
5,IMG_6897.jpg,1,tip,203,565,2291,2729,438,362,384,2510,"[{'type': 'rectangle', 'coordinates': {'y': 2510.0, 'width': 362.0, 'x': 384.0, 'height': 438.0}, 'label': 'Object'}]"
6,IMG_6908.jpg,1,tip,589,961,1469,1888,419,372,775,1678,"[{'type': 'rectangle', 'coordinates': {'y': 1678.0, 'width': 372.0, 'x': 775.0, 'height': 419.0}, 'label': 'Object'}]"
7,IMG_6934.jpg,1,tip,758,1200,1738,2115,377,442,979,1926,"[{'type': 'rectangle', 'coordinates': {'y': 1926.0, 'width': 442.0, 'x': 979.0, 'height': 377.0}, 'label': 'Object'}]"
8,IMG_6920.jpg,1,tip,423,777,1993,2240,247,354,600,2116,"[{'type': 'rectangle', 'coordinates': {'y': 2116.0, 'width': 354.0, 'x': 600.0, 'height': 247.0}, 'label': 'Object'}]"
9,IMG_6921.jpg,1,tip,464,782,1907,2122,215,318,623,2014,"[{'type': 'rectangle', 'coordinates': {'y': 2014.0, 'width': 318.0, 'x': 623.0, 'height': 215.0}, 'label': 'Object'}]"
10,IMG_6935.jpg,1,tip,672,1127,1755,2130,375,455,899,1942,"[{'type': 'rectangle', 'coordinates': {'y': 1942.0, 'width': 455.0, 'x': 899.0, 'height': 375.0}, 'label': 'Object'}]"
11,IMG_6909.jpg,1,tip,658,1034,1628,2051,423,376,846,1839,"[{'type': 'rectangle', 'coordinates': {'y': 1839.0, 'width': 376.0, 'x': 846.0, 'height': 423.0}, 'label': 'Object'}]"
12,IMG_6896.jpg,1,tip,169,584,2266,2677,411,415,376,2471,"[{'type': 'rectangle', 'coordinates': {'y': 2471.0, 'width': 415.0, 'x': 376.0, 'height': 411.0}, 'label': 'Object'}]"
13,IMG_6882.jpg,1,tip,237,719,2286,2726,440,482,478,2506,"[{'type': 'rectangle', 'coordinates': {'y': 2506.0, 'width': 482.0, 'x': 478.0, 'height': 440.0}, 'label': 'Object'}]"
14,IMG_6855.jpg,1,tip,887,1208,1650,2007,357,321,1047,1828,"[{'type': 'rectangle', 'coordinates': {'y': 1828.0, 'width': 321.0, 'x': 1047.0, 'height': 357.0}, 'label': 'Object'}]"
15,IMG_6841.jpg,1,tip,885,1176,2262,2733,471,291,1030,2497,"[{'type': 'rectangle', 'coordinates': {'y': 2497.0, 'width': 291.0, 'x': 1030.0, 'height': 471.0}, 'label': 'Object'}]"
16,IMG_6869.jpg,1,tip,1142,1601,2511,3056,545,459,1371,2783,"[{'type': 'rectangle', 'coordinates': {'y': 2783.0, 'width': 459.0, 'x': 1371.0, 'height': 545.0}, 'label': 'Object'}]"
17,IMG_7008.jpg,1,tip,213,675,1518,1936,418,462,444,1727,"[{'type': 'rectangle', 'coordinates': {'y': 1727.0, 'width': 462.0, 'x': 444.0, 'height': 418.0}, 'label': 'Object'}]"
18,IMG_6857.jpg,1,tip,552,858,1513,1848,335,306,705,1680,"[{'type': 'rectangle', 'coordinates': {'y': 1680.0, 'width': 306.0, 'x': 705.0, 'height': 335.0}, 'label': 'Object'}]"
19,IMG_6843.jpg,1,tip,1029,1315,2325,2743,418,286,1172,2534,"[{'type': 'rectangle', 'coordinates': {'y': 2534.0, 'width': 286.0, 'x': 1172.0, 'height': 418.0}, 'label': 'Object'}]"
20,IMG_6894.jpg,1,tip,213,687,2166,2535,369,474,450,2350,"[{'type': 'rectangle', 'coordinates': {'y': 2350.0, 'width': 474.0, 'x': 450.0, 'height': 369.0}, 'label': 'Object'}]"
21,IMG_6880.jpg,1,tip,643,1261,2372,2853,481,618,952,2612,"[{'type': 'rectangle', 'coordinates': {'y': 2612.0, 'width': 618.0, 'x': 952.0, 'height': 481.0}, 'label': 'Object'}]"
22,IMG_6923.jpg,1,tip,670,966,2022,2262,240,296,818,2142,"[{'type': 'rectangle', 'coordinates': {'y': 2142.0, 'width': 296.0, 'x': 818.0, 'height': 240.0}, 'label': 'Object'}]"
23,IMG_6937.jpg,1,tip,616,1029,1738,2137,399,413,822,1937,"[{'type': 'rectangle', 'coordinates': {'y': 1937.0, 'width': 413.0, 'x': 822.0, 'height': 399.0}, 'label': 'Object'}]"
24,IMG_6936.jpg,1,tip,650,1081,1802,2191,389,431,865,1996,"[{'type': 'rectangle', 'coordinates': {'y': 1996.0, 'width': 431.0, 'x': 865.0, 'height': 389.0}, 'label': 'Object'}]"
25,IMG_6922.jpg,1,tip,604,905,1956,2171,215,301,754,2063,"[{'type': 'rectangle', 'coordinates': {'y': 2063.0, 'width': 301.0, 'x': 754.0, 'height': 215.0}, 'label': 'Object'}]"
26,IMG_6881.jpg,1,tip,562,1274,2362,2910,548,712,918,2636,"[{'type': 'rectangle', 'coordinates': {'y': 2636.0, 'width': 712.0, 'x': 918.0, 'height': 548.0}, 'label': 'Object'}]"
27,IMG_6895.jpg,1,tip,230,709,2215,2663,448,479,469,2439,"[{'type': 'rectangle', 'coordinates': {'y': 2439.0, 'width': 479.0, 'x': 469.0, 'height': 448.0}, 'label': 'Object'}]"
28,IMG_6842.jpg,1,tip,978,1252,2254,2716,462,274,1115,2485,"[{'type': 'rectangle', 'coordinates': {'y': 2485.0, 'width': 274.0, 'x': 1115.0, 'height': 462.0}, 'label': 'Object'}]"
29,IMG_6856.jpg,1,tip,675,1000,1535,1902,367,325,837,1718,"[{'type': 'rectangle', 'coordinates': {'y': 1718.0, 'width': 325.0, 'x': 837.0, 'height': 367.0}, 'label': 'Object'}]"
30,IMG_7027.jpg,1,tip,530,946,1450,1880,430,416,738,1665,"[{'type': 'rectangle', 'coordinates': {'y': 1665.0, 'width': 416.0, 'x': 738.0, 'height': 430.0}, 'label': 'Object'}]"
31,IMG_6852.jpg,1,tip,1041,1362,1628,1963,335,321,1201,1795,"[{'type': 'rectangle', 'coordinates': {'y': 1795.0, 'width': 321.0, 'x': 1201.0, 'height': 335.0}, 'label': 'Object'}]"
32,IMG_6846.jpg,1,tip,1071,1430,2254,2748,494,359,1250,2501,"[{'type': 'rectangle', 'coordinates': {'y': 2501.0, 'width': 359.0, 'x': 1250.0, 'height': 494.0}, 'label': 'Object'}]"
33,IMG_6891.jpg,1,tip,511,1049,2215,2606,391,538,780,2410,"[{'type': 'rectangle', 'coordinates': {'y': 2410.0, 'width': 538.0, 'x': 780.0, 'height': 391.0}, 'label': 'Object'}]"
34,IMG_6885.jpg,1,tip,386,829,2286,2658,372,443,607,2472,"[{'type': 'rectangle', 'coordinates': {'y': 2472.0, 'width': 443.0, 'x': 607.0, 'height': 372.0}, 'label': 'Object'}]"
35,IMG_6926.jpg,1,tip,491,836,1885,2130,245,345,663,2007,"[{'type': 'rectangle', 'coordinates': {'y': 2007.0, 'width': 345.0, 'x': 663.0, 'height': 245.0}, 'label': 'Object'}]"
36,IMG_6932.jpg,1,tip,601,895,2333,2570,237,294,748,2451,"[{'type': 'rectangle', 'coordinates': {'y': 2451.0, 'width': 294.0, 'x': 748.0, 'height': 237.0}, 'label': 'Object'}]"
37,IMG_6933.jpg,1,tip,951,1252,2428,2643,215,301,1101,2535,"[{'type': 'rectangle', 'coordinates': {'y': 2535.0, 'width': 301.0, 'x': 1101.0, 'height': 215.0}, 'label': 'Object'}]"
38,IMG_6927.jpg,1,tip,447,763,1792,2032,240,316,605,1912,"[{'type': 'rectangle', 'coordinates': {'y': 1912.0, 'width': 316.0, 'x': 605.0, 'height': 240.0}, 'label': 'Object'}]"
39,IMG_6884.jpg,1,tip,159,680,2271,2733,462,521,419,2502,"[{'type': 'rectangle', 'coordinates': {'y': 2502.0, 'width': 521.0, 'x': 419.0, 'height': 462.0}, 'label': 'Object'}]"
40,IMG_6890.jpg,1,tip,704,1110,2205,2575,370,406,907,2390,"[{'type': 'rectangle', 'coordinates': {'y': 2390.0, 'width': 406.0, 'x': 907.0, 'height': 370.0}, 'label': 'Object'}]"
41,IMG_6847.jpg,1,tip,660,1054,1768,2137,369,394,857,1952,"[{'type': 'rectangle', 'coordinates': {'y': 1952.0, 'width': 394.0, 'x': 857.0, 'height': 369.0}, 'label': 'Object'}]"
42,IMG_6853.jpg,1,tip,1039,1352,1680,2039,359,313,1195,1859,"[{'type': 'rectangle', 'coordinates': {'y': 1859.0, 'width': 313.0, 'x': 1195.0, 'height': 359.0}, 'label': 'Object'}]"
43,IMG_7026.jpg,1,tip,528,1005,1462,1875,413,477,766,1668,"[{'type': 'rectangle', 'coordinates': {'y': 1668.0, 'width': 477.0, 'x': 766.0, 'height': 413.0}, 'label': 'Object'}]"
44,IMG_7030.jpg,1,tip,606,919,1655,2076,421,313,762,1865,"[{'type': 'rectangle', 'coordinates': {'y': 1865.0, 'width': 313.0, 'x': 762.0, 'height': 421.0}, 'label': 'Object'}]"
45,IMG_6845.jpg,1,tip,1115,1415,2548,3015,467,300,1265,2781,"[{'type': 'rectangle', 'coordinates': {'y': 2781.0, 'width': 300.0, 'x': 1265.0, 'height': 467.0}, 'label': 'Object'}]"
46,IMG_6851.jpg,1,tip,1132,1494,1631,1998,367,362,1313,1814,"[{'type': 'rectangle', 'coordinates': {'y': 1814.0, 'width': 362.0, 'x': 1313.0, 'height': 367.0}, 'label': 'Object'}]"
47,IMG_6879.jpg,1,tip,606,1049,2164,2631,467,443,827,2397,"[{'type': 'rectangle', 'coordinates': {'y': 2397.0, 'width': 443.0, 'x': 827.0, 'height': 467.0}, 'label': 'Object'}]"
48,IMG_6886.jpg,1,tip,347,785,2203,2587,384,438,566,2395,"[{'type': 'rectangle', 'coordinates': {'y': 2395.0, 'width': 438.0, 'x': 566.0, 'height': 384.0}, 'label': 'Object'}]"
49,IMG_6892.jpg,1,tip,381,912,2188,2594,406,531,646,2391,"[{'type': 'rectangle', 'coordinates': {'y': 2391.0, 'width': 531.0, 'x': 646.0, 'height': 406.0}, 'label': 'Object'}]"
50,IMG_6931.jpg,1,tip,834,1186,2296,2543,247,352,1010,2419,"[{'type': 'rectangle', 'coordinates': {'y': 2419.0, 'width': 352.0, 'x': 1010.0, 'height': 247.0}, 'label': 'Object'}]"
51,IMG_6925.jpg,1,tip,491,821,1885,2127,242,330,656,2006,"[{'type': 'rectangle', 'coordinates': {'y': 2006.0, 'width': 330.0, 'x': 656.0, 'height': 242.0}, 'label': 'Object'}]"
52,IMG_6919.jpg,1,tip,403,773,1922,2174,252,370,588,2048,"[{'type': 'rectangle', 'coordinates': {'y': 2048.0, 'width': 370.0, 'x': 588.0, 'height': 252.0}, 'label': 'Object'}]"
53,IMG_6918.jpg,1,tip,438,775,1961,2186,225,337,606,2073,"[{'type': 'rectangle', 'coordinates': {'y': 2073.0, 'width': 337.0, 'x': 606.0, 'height': 225.0}, 'label': 'Object'}]"
54,IMG_6924.jpg,1,tip,401,685,1822,2061,239,284,543,1941,"[{'type': 'rectangle', 'coordinates': {'y': 1941.0, 'width': 284.0, 'x': 543.0, 'height': 239.0}, 'label': 'Object'}]"
55,IMG_6930.jpg,1,tip,398,680,1846,2078,232,282,539,1962,"[{'type': 'rectangle', 'coordinates': {'y': 1962.0, 'width': 282.0, 'x': 539.0, 'height': 232.0}, 'label': 'Object'}]"
56,IMG_6893.jpg,1,tip,222,741,2134,2533,399,519,481,2333,"[{'type': 'rectangle', 'coordinates': {'y': 2333.0, 'width': 519.0, 'x': 481.0, 'height': 399.0}, 'label': 'Object'}]"
57,IMG_6887.jpg,1,tip,313,768,2200,2589,389,455,540,2394,"[{'type': 'rectangle', 'coordinates': {'y': 2394.0, 'width': 455.0, 'x': 540.0, 'height': 389.0}, 'label': 'Object'}]"
58,IMG_6878.jpg,1,tip,570,1012,2122,2584,462,442,791,2353,"[{'type': 'rectangle', 'coordinates': {'y': 2353.0, 'width': 442.0, 'x': 791.0, 'height': 462.0}, 'label': 'Object'}]"
59,IMG_6850.jpg,1,tip,1049,1440,1687,2059,372,391,1244,1873,"[{'type': 'rectangle', 'coordinates': {'y': 1873.0, 'width': 391.0, 'x': 1244.0, 'height': 372.0}, 'label': 'Object'}]"
60,IMG_6844.jpg,1,tip,922,1210,2284,2719,435,288,1066,2501,"[{'type': 'rectangle', 'coordinates': {'y': 2501.0, 'width': 288.0, 'x': 1066.0, 'height': 435.0}, 'label': 'Object'}]"
61,IMG_7081.jpg,1,tip,521,1010,1230,1758,528,489,765,1494,"[{'type': 'rectangle', 'coordinates': {'y': 1494.0, 'width': 489.0, 'x': 765.0, 'height': 528.0}, 'label': 'Object'}]"
62,IMG_7042.jpg,1,tip,1156,1609,1787,2335,548,453,1382,2061,"[{'type': 'rectangle', 'coordinates': {'y': 2061.0, 'width': 453.0, 'x': 1382.0, 'height': 548.0}, 'label': 'Object'}]"
63,IMG_7056.jpg,1,tip,420,887,1479,1961,482,467,653,1720,"[{'type': 'rectangle', 'coordinates': {'y': 1720.0, 'width': 467.0, 'x': 653.0, 'height': 482.0}, 'label': 'Object'}]"
64,IMG_6823.jpg,1,tip,1176,1601,1557,1995,438,425,1388,1776,"[{'type': 'rectangle', 'coordinates': {'y': 1776.0, 'width': 425.0, 'x': 1388.0, 'height': 438.0}, 'label': 'Object'}]"
65,IMG_6837.jpg,1,tip,1286,1604,2264,2719,455,318,1445,2491,"[{'type': 'rectangle', 'coordinates': {'y': 2491.0, 'width': 318.0, 'x': 1445.0, 'height': 455.0}, 'label': 'Object'}]"
66,IMG_6957.jpg,1,tip,865,1340,2257,2699,442,475,1102,2478,"[{'type': 'rectangle', 'coordinates': {'y': 2478.0, 'width': 475.0, 'x': 1102.0, 'height': 442.0}, 'label': 'Object'}]"
67,IMG_6943.jpg,1,tip,440,790,1357,1758,401,350,615,1557,"[{'type': 'rectangle', 'coordinates': {'y': 1557.0, 'width': 350.0, 'x': 615.0, 'height': 401.0}, 'label': 'Object'}]"
68,IMG_6770.jpg,1,tip,1023,2090,1183,2273,1090,1067,1556,1728,"[{'type': 'rectangle', 'coordinates': {'y': 1728.0, 'width': 1067.0, 'x': 1556.0, 'height': 1090.0}, 'label': 'Object'}]"
69,IMG_6764.jpg,1,tip,797,2078,800,2470,1670,1281,1437,1635,"[{'type': 'rectangle', 'coordinates': {'y': 1635.0, 'width': 1281.0, 'x': 1437.0, 'height': 1670.0}, 'label': 'Object'}]"
70,IMG_6994.jpg,1,tip,1059,1455,1499,2071,572,396,1257,1785,"[{'type': 'rectangle', 'coordinates': {'y': 1785.0, 'width': 396.0, 'x': 1257.0, 'height': 572.0}, 'label': 'Object'}]"
71,IMG_6980.jpg,1,tip,724,1191,2181,2663,482,467,957,2422,"[{'type': 'rectangle', 'coordinates': {'y': 2422.0, 'width': 467.0, 'x': 957.0, 'height': 482.0}, 'label': 'Object'}]"
72,IMG_6758.jpg,1,tip,803,2208,1947,2961,1014,1405,1505,2454,"[{'type': 'rectangle', 'coordinates': {'y': 2454.0, 'width': 1405.0, 'x': 1505.0, 'height': 1014.0}, 'label': 'Object'}]"
73,IMG_7122.jpg,1,tip,716,1261,1570,2090,520,545,988,1830,"[{'type': 'rectangle', 'coordinates': {'y': 1830.0, 'width': 545.0, 'x': 988.0, 'height': 520.0}, 'label': 'Object'}]"
74,IMG_7123.jpg,1,tip,599,1169,1611,2159,548,570,884,1885,"[{'type': 'rectangle', 'coordinates': {'y': 1885.0, 'width': 570.0, 'x': 884.0, 'height': 548.0}, 'label': 'Object'}]"
75,IMG_6759.jpg,1,tip,717,1950,300,2002,1702,1233,1333,1151,"[{'type': 'rectangle', 'coordinates': {'y': 1151.0, 'width': 1233.0, 'x': 1333.0, 'height': 1702.0}, 'label': 'Object'}]"
76,IMG_6981.jpg,1,tip,543,993,1689,2156,467,450,768,1922,"[{'type': 'rectangle', 'coordinates': {'y': 1922.0, 'width': 450.0, 'x': 768.0, 'height': 467.0}, 'label': 'Object'}]"
77,IMG_6995.jpg,1,tip,985,1413,1528,2054,526,428,1199,1791,"[{'type': 'rectangle', 'coordinates': {'y': 1791.0, 'width': 428.0, 'x': 1199.0, 'height': 526.0}, 'label': 'Object'}]"
78,IMG_6765.jpg,1,tip,605,1679,991,2808,1817,1074,1142,1899,"[{'type': 'rectangle', 'coordinates': {'y': 1899.0, 'width': 1074.0, 'x': 1142.0, 'height': 1817.0}, 'label': 'Object'}]"
79,IMG_6771.jpg,1,tip,688,2256,1437,3194,1757,1568,1472,2315,"[{'type': 'rectangle', 'coordinates': {'y': 2315.0, 'width': 1568.0, 'x': 1472.0, 'height': 1757.0}, 'label': 'Object'}]"
80,IMG_6942.jpg,1,tip,464,790,1430,1755,325,326,627,1592,"[{'type': 'rectangle', 'coordinates': {'y': 1592.0, 'width': 326.0, 'x': 627.0, 'height': 325.0}, 'label': 'Object'}]"
81,IMG_6956.jpg,1,tip,667,1093,2171,2626,455,426,880,2398,"[{'type': 'rectangle', 'coordinates': {'y': 2398.0, 'width': 426.0, 'x': 880.0, 'height': 455.0}, 'label': 'Object'}]"
82,IMG_6836.jpg,1,tip,1095,1452,2117,2562,445,357,1273,2339,"[{'type': 'rectangle', 'coordinates': {'y': 2339.0, 'width': 357.0, 'x': 1273.0, 'height': 445.0}, 'label': 'Object'}]"
83,IMG_6822.jpg,1,tip,1315,1750,1645,2056,411,435,1532,1850,"[{'type': 'rectangle', 'coordinates': {'y': 1850.0, 'width': 435.0, 'x': 1532.0, 'height': 411.0}, 'label': 'Object'}]"
84,IMG_7057.jpg,1,tip,433,870,1491,1932,441,437,651,1711,"[{'type': 'rectangle', 'coordinates': {'y': 1711.0, 'width': 437.0, 'x': 651.0, 'height': 441.0}, 'label': 'Object'}]"
85,IMG_7043.jpg,1,tip,1259,1704,1934,2474,540,445,1481,2204,"[{'type': 'rectangle', 'coordinates': {'y': 2204.0, 'width': 445.0, 'x': 1481.0, 'height': 540.0}, 'label': 'Object'}]"
86,IMG_7080.jpg,1,tip,452,1081,1408,1976,568,629,766,1692,"[{'type': 'rectangle', 'coordinates': {'y': 1692.0, 'width': 629.0, 'x': 766.0, 'height': 568.0}, 'label': 'Object'}]"
87,IMG_7082.jpg,1,tip,491,978,1350,1883,533,487,734,1616,"[{'type': 'rectangle', 'coordinates': {'y': 1616.0, 'width': 487.0, 'x': 734.0, 'height': 533.0}, 'label': 'Object'}]"
88,IMG_7055.jpg,1,tip,342,853,1445,1902,457,511,597,1673,"[{'type': 'rectangle', 'coordinates': {'y': 1673.0, 'width': 511.0, 'x': 597.0, 'height': 457.0}, 'label': 'Object'}]"
89,IMG_7041.jpg,1,tip,1000,1481,1902,2457,555,481,1240,2179,"[{'type': 'rectangle', 'coordinates': {'y': 2179.0, 'width': 481.0, 'x': 1240.0, 'height': 555.0}, 'label': 'Object'}]"
90,IMG_6808.jpg,1,tip,870,1239,2066,2570,504,369,1054,2318,"[{'type': 'rectangle', 'coordinates': {'y': 2318.0, 'width': 369.0, 'x': 1054.0, 'height': 504.0}, 'label': 'Object'}]"
91,IMG_6834.jpg,1,tip,1063,1420,2240,2682,442,357,1241,2461,"[{'type': 'rectangle', 'coordinates': {'y': 2461.0, 'width': 357.0, 'x': 1241.0, 'height': 442.0}, 'label': 'Object'}]"
92,IMG_6820.jpg,1,tip,1684,2090,1660,2125,465,406,1887,1892,"[{'type': 'rectangle', 'coordinates': {'y': 1892.0, 'width': 406.0, 'x': 1887.0, 'height': 465.0}, 'label': 'Object'}]"
93,IMG_6968.jpg,1,tip,1081,1489,1731,2215,484,408,1285,1973,"[{'type': 'rectangle', 'coordinates': {'y': 1973.0, 'width': 408.0, 'x': 1285.0, 'height': 484.0}, 'label': 'Object'}]"
94,IMG_6798.jpg,1,tip,1316,2215,1782,2690,908,899,1765,2236,"[{'type': 'rectangle', 'coordinates': {'y': 2236.0, 'width': 899.0, 'x': 1765.0, 'height': 908.0}, 'label': 'Object'}]"
95,IMG_6940.jpg,1,tip,496,853,1465,1844,379,357,674,1654,"[{'type': 'rectangle', 'coordinates': {'y': 1654.0, 'width': 357.0, 'x': 674.0, 'height': 379.0}, 'label': 'Object'}]"
96,IMG_6954.jpg,1,tip,807,1259,2298,2714,416,452,1033,2506,"[{'type': 'rectangle', 'coordinates': {'y': 2506.0, 'width': 452.0, 'x': 1033.0, 'height': 416.0}, 'label': 'Object'}]"
97,IMG_6767.jpg,1,tip,899,1858,1970,3095,1125,959,1378,2532,"[{'type': 'rectangle', 'coordinates': {'y': 2532.0, 'width': 959.0, 'x': 1378.0, 'height': 1125.0}, 'label': 'Object'}]"
98,IMG_6773.jpg,1,tip,921,2090,1447,2665,1218,1169,1505,2056,"[{'type': 'rectangle', 'coordinates': {'y': 2056.0, 'width': 1169.0, 'x': 1505.0, 'height': 1218.0}, 'label': 'Object'}]"
99,IMG_6983.jpg,1,tip,274,760,1068,1626,558,486,517,1347,"[{'type': 'rectangle', 'coordinates': {'y': 1347.0, 'width': 486.0, 'x': 517.0, 'height': 558.0}, 'label': 'Object'}]"
100,IMG_6997.jpg,1,tip,636,1181,1521,2066,545,545,908,1793,"[{'type': 'rectangle', 'coordinates': {'y': 1793.0, 'width': 545.0, 'x': 908.0, 'height': 545.0}, 'label': 'Object'}]"
101,IMG_7109.jpg,1,tip,1203,1701,2310,2880,570,498,1452,2595,"[{'type': 'rectangle', 'coordinates': {'y': 2595.0, 'width': 498.0, 'x': 1452.0, 'height': 570.0}, 'label': 'Object'}]"
102,IMG_7121.jpg,1,tip,714,1313,1499,2064,565,599,1013,1781,"[{'type': 'rectangle', 'coordinates': {'y': 1781.0, 'width': 599.0, 'x': 1013.0, 'height': 565.0}, 'label': 'Object'}]"
103,IMG_7120.jpg,1,tip,557,1183,1335,1927,592,626,870,1631,"[{'type': 'rectangle', 'coordinates': {'y': 1631.0, 'width': 626.0, 'x': 870.0, 'height': 592.0}, 'label': 'Object'}]"
104,IMG_7108.jpg,1,tip,1213,1684,2222,2824,602,471,1448,2523,"[{'type': 'rectangle', 'coordinates': {'y': 2523.0, 'width': 471.0, 'x': 1448.0, 'height': 602.0}, 'label': 'Object'}]"
105,IMG_6996.jpg,1,tip,887,1335,1528,2132,604,448,1111,1830,"[{'type': 'rectangle', 'coordinates': {'y': 1830.0, 'width': 448.0, 'x': 1111.0, 'height': 604.0}, 'label': 'Object'}]"
106,IMG_6982.jpg,1,tip,435,944,1086,1562,476,509,689,1324,"[{'type': 'rectangle', 'coordinates': {'y': 1324.0, 'width': 509.0, 'x': 689.0, 'height': 476.0}, 'label': 'Object'}]"
107,IMG_6772.jpg,1,tip,819,1778,1683,2725,1042,959,1298,2204,"[{'type': 'rectangle', 'coordinates': {'y': 2204.0, 'width': 959.0, 'x': 1298.0, 'height': 1042.0}, 'label': 'Object'}]"
108,IMG_6766.jpg,1,tip,1026,1530,1348,2030,682,504,1278,1689,"[{'type': 'rectangle', 'coordinates': {'y': 1689.0, 'width': 504.0, 'x': 1278.0, 'height': 682.0}, 'label': 'Object'}]"
109,IMG_6955.jpg,1,tip,719,1193,2210,2653,443,474,956,2431,"[{'type': 'rectangle', 'coordinates': {'y': 2431.0, 'width': 474.0, 'x': 956.0, 'height': 443.0}, 'label': 'Object'}]"
110,IMG_6941.jpg,1,tip,464,829,1423,1829,406,365,646,1626,"[{'type': 'rectangle', 'coordinates': {'y': 1626.0, 'width': 365.0, 'x': 646.0, 'height': 406.0}, 'label': 'Object'}]"
111,IMG_6799.jpg,1,tip,1628,2527,2008,2904,896,899,2077,2456,"[{'type': 'rectangle', 'coordinates': {'y': 2456.0, 'width': 899.0, 'x': 2077.0, 'height': 896.0}, 'label': 'Object'}]"
112,IMG_6969.jpg,1,tip,1178,1557,1711,2183,472,379,1367,1947,"[{'type': 'rectangle', 'coordinates': {'y': 1947.0, 'width': 379.0, 'x': 1367.0, 'height': 472.0}, 'label': 'Object'}]"
113,IMG_6821.jpg,1,tip,1770,2217,1687,2164,477,447,1993,1925,"[{'type': 'rectangle', 'coordinates': {'y': 1925.0, 'width': 447.0, 'x': 1993.0, 'height': 477.0}, 'label': 'Object'}]"
114,IMG_6835.jpg,1,tip,1017,1467,2159,2619,460,450,1242,2389,"[{'type': 'rectangle', 'coordinates': {'y': 2389.0, 'width': 450.0, 'x': 1242.0, 'height': 460.0}, 'label': 'Object'}]"
115,IMG_6809.jpg,1,tip,792,1293,2039,2513,474,501,1042,2276,"[{'type': 'rectangle', 'coordinates': {'y': 2276.0, 'width': 501.0, 'x': 1042.0, 'height': 474.0}, 'label': 'Object'}]"
116,IMG_7054.jpg,1,tip,396,939,1472,1939,467,543,667,1705,"[{'type': 'rectangle', 'coordinates': {'y': 1705.0, 'width': 543.0, 'x': 667.0, 'height': 467.0}, 'label': 'Object'}]"
117,IMG_7083.jpg,1,tip,584,1041,1474,1968,494,457,812,1721,"[{'type': 'rectangle', 'coordinates': {'y': 1721.0, 'width': 457.0, 'x': 812.0, 'height': 494.0}, 'label': 'Object'}]"
118,IMG_7087.jpg,1,tip,467,956,1577,2127,550,489,711,1852,"[{'type': 'rectangle', 'coordinates': {'y': 1852.0, 'width': 489.0, 'x': 711.0, 'height': 550.0}, 'label': 'Object'}]"
119,IMG_7050.jpg,1,tip,1015,1455,2227,2751,524,440,1235,2489,"[{'type': 'rectangle', 'coordinates': {'y': 2489.0, 'width': 440.0, 'x': 1235.0, 'height': 524.0}, 'label': 'Object'}]"
120,IMG_7044.jpg,1,tip,1115,1567,1922,2443,521,452,1341,2182,"[{'type': 'rectangle', 'coordinates': {'y': 2182.0, 'width': 452.0, 'x': 1341.0, 'height': 521.0}, 'label': 'Object'}]"
121,IMG_7078.jpg,1,tip,298,1000,1523,2081,558,702,649,1802,"[{'type': 'rectangle', 'coordinates': {'y': 1802.0, 'width': 702.0, 'x': 649.0, 'height': 558.0}, 'label': 'Object'}]"
122,IMG_6831.jpg,1,tip,795,1120,1526,1917,391,325,957,1721,"[{'type': 'rectangle', 'coordinates': {'y': 1721.0, 'width': 325.0, 'x': 957.0, 'height': 391.0}, 'label': 'Object'}]"
123,IMG_6825.jpg,1,tip,1442,1838,2335,2773,438,396,1640,2554,"[{'type': 'rectangle', 'coordinates': {'y': 2554.0, 'width': 396.0, 'x': 1640.0, 'height': 438.0}, 'label': 'Object'}]"
124,IMG_6819.jpg,1,tip,1631,1997,1724,2215,491,366,1814,1969,"[{'type': 'rectangle', 'coordinates': {'y': 1969.0, 'width': 366.0, 'x': 1814.0, 'height': 491.0}, 'label': 'Object'}]"
125,IMG_6945.jpg,1,tip,521,973,1912,2372,460,452,747,2142,"[{'type': 'rectangle', 'coordinates': {'y': 2142.0, 'width': 452.0, 'x': 747.0, 'height': 460.0}, 'label': 'Object'}]"
126,IMG_6789.jpg,1,tip,902,2058,1692,2620,928,1156,1480,2156,"[{'type': 'rectangle', 'coordinates': {'y': 2156.0, 'width': 1156.0, 'x': 1480.0, 'height': 928.0}, 'label': 'Object'}]"
127,IMG_6951.jpg,1,tip,856,1340,2298,2719,421,484,1098,2508,"[{'type': 'rectangle', 'coordinates': {'y': 2508.0, 'width': 484.0, 'x': 1098.0, 'height': 421.0}, 'label': 'Object'}]"
128,IMG_6979.jpg,1,tip,934,1364,2132,2604,472,430,1149,2368,"[{'type': 'rectangle', 'coordinates': {'y': 2368.0, 'width': 430.0, 'x': 1149.0, 'height': 472.0}, 'label': 'Object'}]"
129,IMG_6986.jpg,1,tip,697,1127,858,1379,521,430,912,1118,"[{'type': 'rectangle', 'coordinates': {'y': 1118.0, 'width': 430.0, 'x': 912.0, 'height': 521.0}, 'label': 'Object'}]"
130,IMG_6992.jpg,1,tip,1147,1574,1462,1988,526,427,1360,1725,"[{'type': 'rectangle', 'coordinates': {'y': 1725.0, 'width': 427.0, 'x': 1360.0, 'height': 526.0}, 'label': 'Object'}]"
131,IMG_6762.jpg,1,tip,191,1329,1074,2725,1651,1138,760,1899,"[{'type': 'rectangle', 'coordinates': {'y': 1899.0, 'width': 1138.0, 'x': 760.0, 'height': 1651.0}, 'label': 'Object'}]"
132,IMG_6776.jpg,1,tip,1001,2893,1938,3079,1141,1892,1947,2508,"[{'type': 'rectangle', 'coordinates': {'y': 2508.0, 'width': 1892.0, 'x': 1947.0, 'height': 1141.0}, 'label': 'Object'}]"
133,IMG_6777.jpg,1,tip,870,2702,1740,2614,874,1832,1786,2177,"[{'type': 'rectangle', 'coordinates': {'y': 2177.0, 'width': 1832.0, 'x': 1786.0, 'height': 874.0}, 'label': 'Object'}]"
134,IMG_6763.jpg,1,tip,268,1552,806,2639,1833,1284,910,1722,"[{'type': 'rectangle', 'coordinates': {'y': 1722.0, 'width': 1284.0, 'x': 910.0, 'height': 1833.0}, 'label': 'Object'}]"
135,IMG_6993.jpg,1,tip,1066,1535,1384,1988,604,469,1300,1686,"[{'type': 'rectangle', 'coordinates': {'y': 1686.0, 'width': 469.0, 'x': 1300.0, 'height': 604.0}, 'label': 'Object'}]"
136,IMG_6987.jpg,1,tip,663,1107,760,1293,533,444,885,1026,"[{'type': 'rectangle', 'coordinates': {'y': 1026.0, 'width': 444.0, 'x': 885.0, 'height': 533.0}, 'label': 'Object'}]"
137,IMG_6978.jpg,1,tip,1098,1508,1973,2440,467,410,1303,2206,"[{'type': 'rectangle', 'coordinates': {'y': 2206.0, 'width': 410.0, 'x': 1303.0, 'height': 467.0}, 'label': 'Object'}]"
138,IMG_6950.jpg,1,tip,843,1337,2391,2870,479,494,1090,2630,"[{'type': 'rectangle', 'coordinates': {'y': 2630.0, 'width': 494.0, 'x': 1090.0, 'height': 479.0}, 'label': 'Object'}]"
139,IMG_6788.jpg,1,tip,1342,2189,1457,2387,930,847,1765,1922,"[{'type': 'rectangle', 'coordinates': {'y': 1922.0, 'width': 847.0, 'x': 1765.0, 'height': 930.0}, 'label': 'Object'}]"
140,IMG_6944.jpg,1,tip,597,1078,1983,2489,506,481,837,2236,"[{'type': 'rectangle', 'coordinates': {'y': 2236.0, 'width': 481.0, 'x': 837.0, 'height': 506.0}, 'label': 'Object'}]"
141,IMG_6818.jpg,1,tip,1523,1841,1875,2374,499,318,1682,2124,"[{'type': 'rectangle', 'coordinates': {'y': 2124.0, 'width': 318.0, 'x': 1682.0, 'height': 499.0}, 'label': 'Object'}]"
142,IMG_6824.jpg,1,tip,1066,1699,1523,1922,399,633,1382,1722,"[{'type': 'rectangle', 'coordinates': {'y': 1722.0, 'width': 633.0, 'x': 1382.0, 'height': 399.0}, 'label': 'Object'}]"
143,IMG_6830.jpg,1,tip,1305,1618,1518,1905,387,313,1461,1711,"[{'type': 'rectangle', 'coordinates': {'y': 1711.0, 'width': 313.0, 'x': 1461.0, 'height': 387.0}, 'label': 'Object'}]"
144,IMG_7079.jpg,1,tip,445,1073,1428,1934,506,628,759,1681,"[{'type': 'rectangle', 'coordinates': {'y': 1681.0, 'width': 628.0, 'x': 759.0, 'height': 506.0}, 'label': 'Object'}]"
145,IMG_7084.jpg,1,tip,572,1112,1474,2051,577,540,842,1762,"[{'type': 'rectangle', 'coordinates': {'y': 1762.0, 'width': 540.0, 'x': 842.0, 'height': 577.0}, 'label': 'Object'}]"
146,IMG_7090.jpg,1,tip,619,936,1939,2443,504,317,777,2191,"[{'type': 'rectangle', 'coordinates': {'y': 2191.0, 'width': 317.0, 'x': 777.0, 'height': 504.0}, 'label': 'Object'}]"
147,IMG_7047.jpg,1,tip,1105,1552,2037,2565,528,447,1328,2301,"[{'type': 'rectangle', 'coordinates': {'y': 2301.0, 'width': 447.0, 'x': 1328.0, 'height': 528.0}, 'label': 'Object'}]"
148,IMG_7053.jpg,1,tip,548,1088,1408,1924,516,540,818,1666,"[{'type': 'rectangle', 'coordinates': {'y': 1666.0, 'width': 540.0, 'x': 818.0, 'height': 516.0}, 'label': 'Object'}]"
149,IMG_6826.jpg,1,tip,1024,1425,2076,2535,459,401,1224,2305,"[{'type': 'rectangle', 'coordinates': {'y': 2305.0, 'width': 401.0, 'x': 1224.0, 'height': 459.0}, 'label': 'Object'}]"
150,IMG_6832.jpg,1,tip,773,1071,1929,2355,426,298,922,2142,"[{'type': 'rectangle', 'coordinates': {'y': 2142.0, 'width': 298.0, 'x': 922.0, 'height': 426.0}, 'label': 'Object'}]"
151,IMG_6952.jpg,1,tip,868,1384,2284,2792,508,516,1126,2538,"[{'type': 'rectangle', 'coordinates': {'y': 2538.0, 'width': 516.0, 'x': 1126.0, 'height': 508.0}, 'label': 'Object'}]"
152,IMG_6946.jpg,1,tip,548,895,1919,2359,440,347,721,2139,"[{'type': 'rectangle', 'coordinates': {'y': 2139.0, 'width': 347.0, 'x': 721.0, 'height': 440.0}, 'label': 'Object'}]"
153,IMG_6991.jpg,1,tip,1093,1467,1418,1905,487,374,1280,1661,"[{'type': 'rectangle', 'coordinates': {'y': 1661.0, 'width': 374.0, 'x': 1280.0, 'height': 487.0}, 'label': 'Object'}]"
154,IMG_6749.jpg,1,tip,688,1985,797,2378,1581,1297,1336,1587,"[{'type': 'rectangle', 'coordinates': {'y': 1587.0, 'width': 1297.0, 'x': 1336.0, 'height': 1581.0}, 'label': 'Object'}]"
155,IMG_6985.jpg,1,tip,597,1034,1269,1751,482,437,815,1510,"[{'type': 'rectangle', 'coordinates': {'y': 1510.0, 'width': 437.0, 'x': 815.0, 'height': 482.0}, 'label': 'Object'}]"
156,IMG_6775.jpg,1,tip,1087,2871,1807,3359,1552,1784,1979,2583,"[{'type': 'rectangle', 'coordinates': {'y': 2583.0, 'width': 1784.0, 'x': 1979.0, 'height': 1552.0}, 'label': 'Object'}]"
157,IMG_6761.jpg,1,tip,593,1947,398,2282,1884,1354,1270,1340,"[{'type': 'rectangle', 'coordinates': {'y': 1340.0, 'width': 1354.0, 'x': 1270.0, 'height': 1884.0}, 'label': 'Object'}]"
158,IMG_6760.jpg,1,tip,800,1969,733,2295,1562,1169,1384,1514,"[{'type': 'rectangle', 'coordinates': {'y': 1514.0, 'width': 1169.0, 'x': 1384.0, 'height': 1562.0}, 'label': 'Object'}]"
159,IMG_6774.jpg,1,tip,1042,2454,816,1842,1026,1412,1748,1329,"[{'type': 'rectangle', 'coordinates': {'y': 1329.0, 'width': 1412.0, 'x': 1748.0, 'height': 1026.0}, 'label': 'Object'}]"
160,IMG_6984.jpg,1,tip,428,856,1254,1724,470,428,642,1489,"[{'type': 'rectangle', 'coordinates': {'y': 1489.0, 'width': 428.0, 'x': 642.0, 'height': 470.0}, 'label': 'Object'}]"
161,IMG_6748.jpg,1,tip,793,1743,1326,2528,1202,950,1268,1927,"[{'type': 'rectangle', 'coordinates': {'y': 1927.0, 'width': 950.0, 'x': 1268.0, 'height': 1202.0}, 'label': 'Object'}]"
162,IMG_6990.jpg,1,tip,1024,1401,1291,1741,450,377,1212,1516,"[{'type': 'rectangle', 'coordinates': {'y': 1516.0, 'width': 377.0, 'x': 1212.0, 'height': 450.0}, 'label': 'Object'}]"
163,IMG_6947.jpg,1,tip,484,765,1966,2379,413,281,624,2172,"[{'type': 'rectangle', 'coordinates': {'y': 2172.0, 'width': 281.0, 'x': 624.0, 'height': 413.0}, 'label': 'Object'}]"
164,IMG_6953.jpg,1,tip,858,1354,2254,2755,501,496,1106,2504,"[{'type': 'rectangle', 'coordinates': {'y': 2504.0, 'width': 496.0, 'x': 1106.0, 'height': 501.0}, 'label': 'Object'}]"
165,IMG_6833.jpg,1,tip,851,1222,2098,2553,455,371,1036,2325,"[{'type': 'rectangle', 'coordinates': {'y': 2325.0, 'width': 371.0, 'x': 1036.0, 'height': 455.0}, 'label': 'Object'}]"
166,IMG_6827.jpg,1,tip,1024,1459,1844,2320,476,435,1241,2082,"[{'type': 'rectangle', 'coordinates': {'y': 2082.0, 'width': 435.0, 'x': 1241.0, 'height': 476.0}, 'label': 'Object'}]"
167,IMG_7052.jpg,1,tip,516,1083,1335,1866,531,567,799,1600,"[{'type': 'rectangle', 'coordinates': {'y': 1600.0, 'width': 567.0, 'x': 799.0, 'height': 531.0}, 'label': 'Object'}]"
168,IMG_7046.jpg,1,tip,1117,1525,2017,2533,516,408,1321,2275,"[{'type': 'rectangle', 'coordinates': {'y': 2275.0, 'width': 408.0, 'x': 1321.0, 'height': 516.0}, 'label': 'Object'}]"
169,IMG_7088.jpg,1,tip,523,1012,1511,2081,570,489,767,1796,"[{'type': 'rectangle', 'coordinates': {'y': 1796.0, 'width': 489.0, 'x': 767.0, 'height': 570.0}, 'label': 'Object'}]"
170,IMG_7077.jpg,1,tip,384,1061,1511,2076,565,677,722,1793,"[{'type': 'rectangle', 'coordinates': {'y': 1793.0, 'width': 677.0, 'x': 722.0, 'height': 565.0}, 'label': 'Object'}]"
171,IMG_6802.jpg,1,tip,1186,1633,1804,2274,470,447,1409,2039,"[{'type': 'rectangle', 'coordinates': {'y': 2039.0, 'width': 447.0, 'x': 1409.0, 'height': 470.0}, 'label': 'Object'}]"
172,IMG_6816.jpg,1,tip,892,1340,2323,2736,413,448,1116,2529,"[{'type': 'rectangle', 'coordinates': {'y': 2529.0, 'width': 448.0, 'x': 1116.0, 'height': 413.0}, 'label': 'Object'}]"
173,IMG_6792.jpg,1,tip,1443,2208,2333,3006,673,765,1825,2669,"[{'type': 'rectangle', 'coordinates': {'y': 2669.0, 'width': 765.0, 'x': 1825.0, 'height': 673.0}, 'label': 'Object'}]"
174,IMG_6786.jpg,1,tip,1383,2011,1989,2544,555,628,1697,2266,"[{'type': 'rectangle', 'coordinates': {'y': 2266.0, 'width': 628.0, 'x': 1697.0, 'height': 555.0}, 'label': 'Object'}]"
175,IMG_6976.jpg,1,tip,1359,1694,1839,2244,405,335,1526,2041,"[{'type': 'rectangle', 'coordinates': {'y': 2041.0, 'width': 335.0, 'x': 1526.0, 'height': 405.0}, 'label': 'Object'}]"
176,IMG_6962.jpg,1,tip,1056,1506,2027,2450,423,450,1281,2238,"[{'type': 'rectangle', 'coordinates': {'y': 2238.0, 'width': 450.0, 'x': 1281.0, 'height': 423.0}, 'label': 'Object'}]"
177,IMG_6989.jpg,1,tip,985,1423,1056,1538,482,438,1204,1297,"[{'type': 'rectangle', 'coordinates': {'y': 1297.0, 'width': 438.0, 'x': 1204.0, 'height': 482.0}, 'label': 'Object'}]"
178,IMG_6751.jpg,1,tip,1198,1969,1865,2760,895,771,1583,2312,"[{'type': 'rectangle', 'coordinates': {'y': 2312.0, 'width': 771.0, 'x': 1583.0, 'height': 895.0}, 'label': 'Object'}]"
179,IMG_6779.jpg,1,tip,762,2517,1275,2763,1488,1755,1639,2019,"[{'type': 'rectangle', 'coordinates': {'y': 2019.0, 'width': 1755.0, 'x': 1639.0, 'height': 1488.0}, 'label': 'Object'}]"
180,IMG_7103.jpg,1,tip,1320,1809,1944,2555,611,489,1564,2249,"[{'type': 'rectangle', 'coordinates': {'y': 2249.0, 'width': 489.0, 'x': 1564.0, 'height': 611.0}, 'label': 'Object'}]"
181,IMG_7102.jpg,1,tip,1313,1814,1892,2487,595,501,1563,2189,"[{'type': 'rectangle', 'coordinates': {'y': 2189.0, 'width': 501.0, 'x': 1563.0, 'height': 595.0}, 'label': 'Object'}]"
182,IMG_6750.jpg,1,tip,554,2071,867,2744,1877,1517,1312,1805,"[{'type': 'rectangle', 'coordinates': {'y': 1805.0, 'width': 1517.0, 'x': 1312.0, 'height': 1877.0}, 'label': 'Object'}]"
183,IMG_6988.jpg,1,tip,846,1315,890,1411,521,469,1080,1150,"[{'type': 'rectangle', 'coordinates': {'y': 1150.0, 'width': 469.0, 'x': 1080.0, 'height': 521.0}, 'label': 'Object'}]"
184,IMG_6963.jpg,1,tip,990,1413,1934,2403,469,423,1201,2168,"[{'type': 'rectangle', 'coordinates': {'y': 2168.0, 'width': 423.0, 'x': 1201.0, 'height': 469.0}, 'label': 'Object'}]"
185,IMG_6977.jpg,1,tip,1330,1687,1902,2303,401,357,1508,2102,"[{'type': 'rectangle', 'coordinates': {'y': 2102.0, 'width': 357.0, 'x': 1508.0, 'height': 401.0}, 'label': 'Object'}]"
186,IMG_6787.jpg,1,tip,1539,1988,2247,2633,386,449,1763,2440,"[{'type': 'rectangle', 'coordinates': {'y': 2440.0, 'width': 449.0, 'x': 1763.0, 'height': 386.0}, 'label': 'Object'}]"
187,IMG_6793.jpg,1,tip,1377,2001,1865,2566,701,624,1689,2215,"[{'type': 'rectangle', 'coordinates': {'y': 2215.0, 'width': 624.0, 'x': 1689.0, 'height': 701.0}, 'label': 'Object'}]"
188,IMG_6817.jpg,1,tip,1391,1733,2064,2523,459,342,1562,2293,"[{'type': 'rectangle', 'coordinates': {'y': 2293.0, 'width': 342.0, 'x': 1562.0, 'height': 459.0}, 'label': 'Object'}]"
189,IMG_6803.jpg,1,tip,1222,1841,1844,2401,557,619,1531,2122,"[{'type': 'rectangle', 'coordinates': {'y': 2122.0, 'width': 619.0, 'x': 1531.0, 'height': 557.0}, 'label': 'Object'}]"
190,IMG_7076.jpg,1,tip,433,1181,1518,2230,712,748,807,1874,"[{'type': 'rectangle', 'coordinates': {'y': 1874.0, 'width': 748.0, 'x': 807.0, 'height': 712.0}, 'label': 'Object'}]"
191,IMG_7089.jpg,1,tip,601,1039,1660,2203,543,438,820,1931,"[{'type': 'rectangle', 'coordinates': {'y': 1931.0, 'width': 438.0, 'x': 820.0, 'height': 543.0}, 'label': 'Object'}]"
192,IMG_7048.jpg,1,tip,1103,1543,2103,2597,494,440,1323,2350,"[{'type': 'rectangle', 'coordinates': {'y': 2350.0, 'width': 440.0, 'x': 1323.0, 'height': 494.0}, 'label': 'Object'}]"
193,IMG_7074.jpg,1,tip,565,1313,1516,2068,552,748,939,1792,"[{'type': 'rectangle', 'coordinates': {'y': 1792.0, 'width': 748.0, 'x': 939.0, 'height': 552.0}, 'label': 'Object'}]"
194,IMG_6829.jpg,1,tip,1078,1437,1890,2379,489,359,1257,2134,"[{'type': 'rectangle', 'coordinates': {'y': 2134.0, 'width': 359.0, 'x': 1257.0, 'height': 489.0}, 'label': 'Object'}]"
195,IMG_6815.jpg,1,tip,1051,1391,2284,2826,542,340,1221,2555,"[{'type': 'rectangle', 'coordinates': {'y': 2555.0, 'width': 340.0, 'x': 1221.0, 'height': 542.0}, 'label': 'Object'}]"
196,IMG_6801.jpg,1,tip,1526,2368,1696,3047,1351,842,1947,2371,"[{'type': 'rectangle', 'coordinates': {'y': 2371.0, 'width': 842.0, 'x': 1947.0, 'height': 1351.0}, 'label': 'Object'}]"
197,IMG_6785.jpg,1,tip,1593,2008,2202,2595,393,415,1800,2398,"[{'type': 'rectangle', 'coordinates': {'y': 2398.0, 'width': 415.0, 'x': 1800.0, 'height': 393.0}, 'label': 'Object'}]"
198,IMG_6791.jpg,1,tip,1335,2718,1590,2719,1129,1383,2026,2154,"[{'type': 'rectangle', 'coordinates': {'y': 2154.0, 'width': 1383.0, 'x': 2026.0, 'height': 1129.0}, 'label': 'Object'}]"
199,IMG_6949.jpg,1,tip,758,1183,2266,2709,443,425,970,2487,"[{'type': 'rectangle', 'coordinates': {'y': 2487.0, 'width': 425.0, 'x': 970.0, 'height': 443.0}, 'label': 'Object'}]"
200,IMG_6961.jpg,1,tip,1110,1601,2122,2550,428,491,1355,2336,"[{'type': 'rectangle', 'coordinates': {'y': 2336.0, 'width': 491.0, 'x': 1355.0, 'height': 428.0}, 'label': 'Object'}]"
201,IMG_6975.jpg,1,tip,1352,1697,1753,2154,401,345,1524,1953,"[{'type': 'rectangle', 'coordinates': {'y': 1953.0, 'width': 345.0, 'x': 1524.0, 'height': 401.0}, 'label': 'Object'}]"
202,IMG_6752.jpg,1,tip,1064,2027,1520,2967,1447,963,1545,2243,"[{'type': 'rectangle', 'coordinates': {'y': 2243.0, 'width': 963.0, 'x': 1545.0, 'height': 1447.0}, 'label': 'Object'}]"
203,IMG_7114.jpg,1,tip,1071,1508,2452,3039,587,437,1289,2745,"[{'type': 'rectangle', 'coordinates': {'y': 2745.0, 'width': 437.0, 'x': 1289.0, 'height': 587.0}, 'label': 'Object'}]"
204,IMG_7115.jpg,1,tip,1120,1535,2445,3054,609,415,1327,2749,"[{'type': 'rectangle', 'coordinates': {'y': 2749.0, 'width': 415.0, 'x': 1327.0, 'height': 609.0}, 'label': 'Object'}]"
205,IMG_6753.jpg,1,tip,835,2304,918,3114,2196,1469,1569,2016,"[{'type': 'rectangle', 'coordinates': {'y': 2016.0, 'width': 1469.0, 'x': 1569.0, 'height': 2196.0}, 'label': 'Object'}]"
206,IMG_6747.jpg,1,tip,707,2087,1332,2830,1498,1380,1397,2081,"[{'type': 'rectangle', 'coordinates': {'y': 2081.0, 'width': 1380.0, 'x': 1397.0, 'height': 1498.0}, 'label': 'Object'}]"
207,IMG_6974.jpg,1,tip,1374,1704,1714,2115,401,330,1539,1914,"[{'type': 'rectangle', 'coordinates': {'y': 1914.0, 'width': 330.0, 'x': 1539.0, 'height': 401.0}, 'label': 'Object'}]"
208,IMG_6960.jpg,1,tip,1110,1545,2193,2660,467,435,1327,2426,"[{'type': 'rectangle', 'coordinates': {'y': 2426.0, 'width': 435.0, 'x': 1327.0, 'height': 467.0}, 'label': 'Object'}]"
209,IMG_6948.jpg,1,tip,726,1093,2244,2643,399,367,909,2443,"[{'type': 'rectangle', 'coordinates': {'y': 2443.0, 'width': 367.0, 'x': 909.0, 'height': 399.0}, 'label': 'Object'}]"
210,IMG_6790.jpg,1,tip,1278,2036,1355,2228,873,758,1657,1791,"[{'type': 'rectangle', 'coordinates': {'y': 1791.0, 'width': 758.0, 'x': 1657.0, 'height': 873.0}, 'label': 'Object'}]"
211,IMG_6784.jpg,1,tip,1804,2415,1865,2320,455,611,2109,2092,"[{'type': 'rectangle', 'coordinates': {'y': 2092.0, 'width': 611.0, 'x': 2109.0, 'height': 455.0}, 'label': 'Object'}]"
212,IMG_6800.jpg,1,tip,309,1389,1766,2894,1128,1080,849,2330,"[{'type': 'rectangle', 'coordinates': {'y': 2330.0, 'width': 1080.0, 'x': 849.0, 'height': 1128.0}, 'label': 'Object'}]"
213,IMG_6814.jpg,1,tip,909,1335,2352,2895,543,426,1122,2623,"[{'type': 'rectangle', 'coordinates': {'y': 2623.0, 'width': 426.0, 'x': 1122.0, 'height': 543.0}, 'label': 'Object'}]"
214,IMG_6828.jpg,1,tip,802,1200,2120,2575,455,398,1001,2347,"[{'type': 'rectangle', 'coordinates': {'y': 2347.0, 'width': 398.0, 'x': 1001.0, 'height': 455.0}, 'label': 'Object'}]"
215,IMG_7075.jpg,1,tip,501,1200,1501,2159,658,699,850,1830,"[{'type': 'rectangle', 'coordinates': {'y': 1830.0, 'width': 699.0, 'x': 850.0, 'height': 658.0}, 'label': 'Object'}]"
216,IMG_7049.jpg,1,tip,1088,1528,2159,2677,518,440,1308,2418,"[{'type': 'rectangle', 'coordinates': {'y': 2418.0, 'width': 440.0, 'x': 1308.0, 'height': 518.0}, 'label': 'Object'}]"
217,IMG_7071.jpg,1,tip,968,1657,1350,2005,655,689,1312,1677,"[{'type': 'rectangle', 'coordinates': {'y': 1677.0, 'width': 689.0, 'x': 1312.0, 'height': 655.0}, 'label': 'Object'}]"
218,IMG_6810.jpg,1,tip,726,1115,1917,2438,521,389,920,2177,"[{'type': 'rectangle', 'coordinates': {'y': 2177.0, 'width': 389.0, 'x': 920.0, 'height': 521.0}, 'label': 'Object'}]"
219,IMG_6804.jpg,1,tip,1276,1653,1927,2362,435,377,1464,2144,"[{'type': 'rectangle', 'coordinates': {'y': 2144.0, 'width': 377.0, 'x': 1464.0, 'height': 435.0}, 'label': 'Object'}]"
220,IMG_6838.jpg,1,tip,929,1266,2159,2601,442,337,1097,2380,"[{'type': 'rectangle', 'coordinates': {'y': 2380.0, 'width': 337.0, 'x': 1097.0, 'height': 442.0}, 'label': 'Object'}]"
221,IMG_6964.jpg,1,tip,922,1364,1895,2364,469,442,1143,2129,"[{'type': 'rectangle', 'coordinates': {'y': 2129.0, 'width': 442.0, 'x': 1143.0, 'height': 469.0}, 'label': 'Object'}]"
222,IMG_6970.jpg,1,tip,1364,1719,1499,1902,403,355,1541,1700,"[{'type': 'rectangle', 'coordinates': {'y': 1700.0, 'width': 355.0, 'x': 1541.0, 'height': 403.0}, 'label': 'Object'}]"
223,IMG_6780.jpg,1,tip,1064,2581,1785,3219,1434,1517,1822,2502,"[{'type': 'rectangle', 'coordinates': {'y': 2502.0, 'width': 1517.0, 'x': 1822.0, 'height': 1434.0}, 'label': 'Object'}]"
224,IMG_6958.jpg,1,tip,934,1362,2303,2751,448,428,1148,2527,"[{'type': 'rectangle', 'coordinates': {'y': 2527.0, 'width': 428.0, 'x': 1148.0, 'height': 448.0}, 'label': 'Object'}]"
225,IMG_6794.jpg,1,tip,1185,1619,2037,2496,459,434,1402,2266,"[{'type': 'rectangle', 'coordinates': {'y': 2266.0, 'width': 434.0, 'x': 1402.0, 'height': 459.0}, 'label': 'Object'}]"
226,IMG_6757.jpg,1,tip,1090,1925,2362,3044,682,835,1507,2703,"[{'type': 'rectangle', 'coordinates': {'y': 2703.0, 'width': 835.0, 'x': 1507.0, 'height': 682.0}, 'label': 'Object'}]"
227,IMG_7105.jpg,1,tip,1313,1750,2115,2702,587,437,1531,2408,"[{'type': 'rectangle', 'coordinates': {'y': 2408.0, 'width': 437.0, 'x': 1531.0, 'height': 587.0}, 'label': 'Object'}]"
228,IMG_7111.jpg,1,tip,1178,1579,2396,2990,594,401,1378,2693,"[{'type': 'rectangle', 'coordinates': {'y': 2693.0, 'width': 401.0, 'x': 1378.0, 'height': 594.0}, 'label': 'Object'}]"
229,IMG_7110.jpg,1,tip,1203,1643,2381,2961,580,440,1423,2671,"[{'type': 'rectangle', 'coordinates': {'y': 2671.0, 'width': 440.0, 'x': 1423.0, 'height': 580.0}, 'label': 'Object'}]"
230,IMG_7104.jpg,1,tip,1320,1790,2066,2655,589,470,1555,2360,"[{'type': 'rectangle', 'coordinates': {'y': 2360.0, 'width': 470.0, 'x': 1555.0, 'height': 589.0}, 'label': 'Object'}]"
231,IMG_6756.jpg,1,tip,762,2285,2454,3573,1119,1523,1523,3013,"[{'type': 'rectangle', 'coordinates': {'y': 3013.0, 'width': 1523.0, 'x': 1523.0, 'height': 1119.0}, 'label': 'Object'}]"
232,IMG_6795.jpg,1,tip,1224,1960,1938,2773,835,736,1592,2355,"[{'type': 'rectangle', 'coordinates': {'y': 2355.0, 'width': 736.0, 'x': 1592.0, 'height': 835.0}, 'label': 'Object'}]"
233,IMG_6959.jpg,1,tip,1007,1445,2330,2755,425,438,1226,2542,"[{'type': 'rectangle', 'coordinates': {'y': 2542.0, 'width': 438.0, 'x': 1226.0, 'height': 425.0}, 'label': 'Object'}]"
234,IMG_6781.jpg,1,tip,1291,2036,1826,2442,616,745,1663,2134,"[{'type': 'rectangle', 'coordinates': {'y': 2134.0, 'width': 745.0, 'x': 1663.0, 'height': 616.0}, 'label': 'Object'}]"
235,IMG_6971.jpg,1,tip,1381,1775,1430,1856,426,394,1578,1643,"[{'type': 'rectangle', 'coordinates': {'y': 1643.0, 'width': 394.0, 'x': 1578.0, 'height': 426.0}, 'label': 'Object'}]"
236,IMG_6965.jpg,1,tip,949,1433,1936,2408,472,484,1191,2172,"[{'type': 'rectangle', 'coordinates': {'y': 2172.0, 'width': 484.0, 'x': 1191.0, 'height': 472.0}, 'label': 'Object'}]"
237,IMG_6839.jpg,1,tip,883,1252,2159,2619,460,369,1067,2389,"[{'type': 'rectangle', 'coordinates': {'y': 2389.0, 'width': 369.0, 'x': 1067.0, 'height': 460.0}, 'label': 'Object'}]"
238,IMG_6805.jpg,1,tip,1181,1567,2137,2587,450,386,1374,2362,"[{'type': 'rectangle', 'coordinates': {'y': 2362.0, 'width': 386.0, 'x': 1374.0, 'height': 450.0}, 'label': 'Object'}]"
239,IMG_6811.jpg,1,tip,619,1078,2078,2499,421,459,848,2288,"[{'type': 'rectangle', 'coordinates': {'y': 2288.0, 'width': 459.0, 'x': 848.0, 'height': 421.0}, 'label': 'Object'}]"
240,IMG_7072.jpg,1,tip,905,1599,1455,2054,599,694,1252,1754,"[{'type': 'rectangle', 'coordinates': {'y': 1754.0, 'width': 694.0, 'x': 1252.0, 'height': 599.0}, 'label': 'Object'}]"
241,IMG_6807.jpg,1,tip,1095,1508,1966,2413,447,413,1301,2189,"[{'type': 'rectangle', 'coordinates': {'y': 2189.0, 'width': 413.0, 'x': 1301.0, 'height': 447.0}, 'label': 'Object'}]"
242,IMG_6813.jpg,1,tip,724,1078,2152,2663,511,354,901,2407,"[{'type': 'rectangle', 'coordinates': {'y': 2407.0, 'width': 354.0, 'x': 901.0, 'height': 511.0}, 'label': 'Object'}]"
243,IMG_6973.jpg,1,tip,1376,1721,1658,2105,447,345,1548,1881,"[{'type': 'rectangle', 'coordinates': {'y': 1881.0, 'width': 345.0, 'x': 1548.0, 'height': 447.0}, 'label': 'Object'}]"
244,IMG_6967.jpg,1,tip,946,1374,1660,2220,560,428,1160,1940,"[{'type': 'rectangle', 'coordinates': {'y': 1940.0, 'width': 428.0, 'x': 1160.0, 'height': 560.0}, 'label': 'Object'}]"
245,IMG_6797.jpg,1,tip,1026,2361,1724,2830,1106,1335,1693,2277,"[{'type': 'rectangle', 'coordinates': {'y': 2277.0, 'width': 1335.0, 'x': 1693.0, 'height': 1106.0}, 'label': 'Object'}]"
246,IMG_6783.jpg,1,tip,1179,1950,1830,2630,800,771,1564,2230,"[{'type': 'rectangle', 'coordinates': {'y': 2230.0, 'width': 771.0, 'x': 1564.0, 'height': 800.0}, 'label': 'Object'}]"
247,IMG_6768.jpg,1,tip,1201,1826,2183,2853,670,625,1513,2518,"[{'type': 'rectangle', 'coordinates': {'y': 2518.0, 'width': 625.0, 'x': 1513.0, 'height': 670.0}, 'label': 'Object'}]"
248,IMG_6754.jpg,1,tip,1195,1644,1785,2314,529,449,1419,2049,"[{'type': 'rectangle', 'coordinates': {'y': 2049.0, 'width': 449.0, 'x': 1419.0, 'height': 529.0}, 'label': 'Object'}]"
249,IMG_6998.jpg,1,tip,692,1298,1499,1941,442,606,995,1720,"[{'type': 'rectangle', 'coordinates': {'y': 1720.0, 'width': 606.0, 'x': 995.0, 'height': 442.0}, 'label': 'Object'}]"
250,IMG_7106.jpg,1,tip,1286,1719,2174,2748,574,433,1502,2461,"[{'type': 'rectangle', 'coordinates': {'y': 2461.0, 'width': 433.0, 'x': 1502.0, 'height': 574.0}, 'label': 'Object'}]"
251,IMG_7107.jpg,1,tip,1232,1684,2200,2748,548,452,1458,2474,"[{'type': 'rectangle', 'coordinates': {'y': 2474.0, 'width': 452.0, 'x': 1458.0, 'height': 548.0}, 'label': 'Object'}]"
252,IMG_6999.jpg,1,tip,606,1178,1597,1998,401,572,892,1797,"[{'type': 'rectangle', 'coordinates': {'y': 1797.0, 'width': 572.0, 'x': 892.0, 'height': 401.0}, 'label': 'Object'}]"
253,IMG_6755.jpg,1,tip,1099,1845,2317,2929,612,746,1472,2623,"[{'type': 'rectangle', 'coordinates': {'y': 2623.0, 'width': 746.0, 'x': 1472.0, 'height': 612.0}, 'label': 'Object'}]"
254,IMG_6769.jpg,1,tip,1383,1832,1884,2289,405,449,1607,2086,"[{'type': 'rectangle', 'coordinates': {'y': 2086.0, 'width': 449.0, 'x': 1607.0, 'height': 405.0}, 'label': 'Object'}]"
255,IMG_6782.jpg,1,tip,1252,1931,2024,2499,475,679,1591,2261,"[{'type': 'rectangle', 'coordinates': {'y': 2261.0, 'width': 679.0, 'x': 1591.0, 'height': 475.0}, 'label': 'Object'}]"
256,IMG_6796.jpg,1,tip,1313,1941,2346,3124,778,628,1627,2735,"[{'type': 'rectangle', 'coordinates': {'y': 2735.0, 'width': 628.0, 'x': 1627.0, 'height': 778.0}, 'label': 'Object'}]"
257,IMG_6966.jpg,1,tip,1066,1472,1822,2284,462,406,1269,2053,"[{'type': 'rectangle', 'coordinates': {'y': 2053.0, 'width': 406.0, 'x': 1269.0, 'height': 462.0}, 'label': 'Object'}]"
258,IMG_6972.jpg,1,tip,1433,1785,1543,1961,418,352,1609,1752,"[{'type': 'rectangle', 'coordinates': {'y': 1752.0, 'width': 352.0, 'x': 1609.0, 'height': 418.0}, 'label': 'Object'}]"
259,IMG_6812.jpg,1,tip,680,1010,2005,2462,457,330,845,2233,"[{'type': 'rectangle', 'coordinates': {'y': 2233.0, 'width': 330.0, 'x': 845.0, 'height': 457.0}, 'label': 'Object'}]"
260,IMG_6806.jpg,1,tip,1310,1706,1968,2377,409,396,1508,2172,"[{'type': 'rectangle', 'coordinates': {'y': 2172.0, 'width': 396.0, 'x': 1508.0, 'height': 409.0}, 'label': 'Object'}]"
261,IMG_7073.jpg,1,tip,667,1398,1570,2093,523,731,1032,1831,"[{'type': 'rectangle', 'coordinates': {'y': 1831.0, 'width': 731.0, 'x': 1032.0, 'height': 523.0}, 'label': 'Object'}]"
262,IMG_7014.jpg,1,tip,508,1000,1086,1548,462,492,754,1317,"[{'type': 'rectangle', 'coordinates': {'y': 1317.0, 'width': 492.0, 'x': 754.0, 'height': 462.0}, 'label': 'Object'}]"
263,IMG_6849.jpg,1,tip,995,1474,1853,2218,365,479,1234,2035,"[{'type': 'rectangle', 'coordinates': {'y': 2035.0, 'width': 479.0, 'x': 1234.0, 'height': 365.0}, 'label': 'Object'}]"
264,IMG_6861.jpg,1,tip,1332,1599,2423,2763,340,267,1465,2593,"[{'type': 'rectangle', 'coordinates': {'y': 2593.0, 'width': 267.0, 'x': 1465.0, 'height': 340.0}, 'label': 'Object'}]"
265,IMG_6875.jpg,1,tip,709,1100,2125,2599,474,391,904,2362,"[{'type': 'rectangle', 'coordinates': {'y': 2362.0, 'width': 391.0, 'x': 904.0, 'height': 474.0}, 'label': 'Object'}]"
266,IMG_6929.jpg,1,tip,464,787,1846,2095,249,323,625,1970,"[{'type': 'rectangle', 'coordinates': {'y': 1970.0, 'width': 323.0, 'x': 625.0, 'height': 249.0}, 'label': 'Object'}]"
267,IMG_6915.jpg,1,tip,694,1039,2039,2284,245,345,866,2161,"[{'type': 'rectangle', 'coordinates': {'y': 2161.0, 'width': 345.0, 'x': 866.0, 'height': 245.0}, 'label': 'Object'}]"
268,IMG_6901.jpg,1,tip,362,743,2707,3078,371,381,552,2892,"[{'type': 'rectangle', 'coordinates': {'y': 2892.0, 'width': 381.0, 'x': 552.0, 'height': 371.0}, 'label': 'Object'}]"
269,IMG_6900.jpg,1,tip,342,685,2567,2978,411,343,513,2772,"[{'type': 'rectangle', 'coordinates': {'y': 2772.0, 'width': 343.0, 'x': 513.0, 'height': 411.0}, 'label': 'Object'}]"
270,IMG_6914.jpg,1,tip,660,1027,1988,2198,210,367,843,2093,"[{'type': 'rectangle', 'coordinates': {'y': 2093.0, 'width': 367.0, 'x': 843.0, 'height': 210.0}, 'label': 'Object'}]"
271,IMG_6928.jpg,1,tip,416,758,1785,2049,264,342,587,1917,"[{'type': 'rectangle', 'coordinates': {'y': 1917.0, 'width': 342.0, 'x': 587.0, 'height': 264.0}, 'label': 'Object'}]"
272,IMG_6874.jpg,1,tip,726,1156,2090,2570,480,430,941,2330,"[{'type': 'rectangle', 'coordinates': {'y': 2330.0, 'width': 430.0, 'x': 941.0, 'height': 480.0}, 'label': 'Object'}]"
273,IMG_6860.jpg,1,tip,1323,1594,2472,2780,308,271,1458,2626,"[{'type': 'rectangle', 'coordinates': {'y': 2626.0, 'width': 271.0, 'x': 1458.0, 'height': 308.0}, 'label': 'Object'}]"
274,IMG_6848.jpg,1,tip,692,1127,1702,2093,391,435,909,1897,"[{'type': 'rectangle', 'coordinates': {'y': 1897.0, 'width': 435.0, 'x': 909.0, 'height': 391.0}, 'label': 'Object'}]"
275,IMG_7015.jpg,1,tip,729,1249,1061,1567,506,520,989,1314,"[{'type': 'rectangle', 'coordinates': {'y': 1314.0, 'width': 520.0, 'x': 989.0, 'height': 506.0}, 'label': 'Object'}]"
276,IMG_7001.jpg,1,tip,452,1132,1792,2281,489,680,792,2036,"[{'type': 'rectangle', 'coordinates': {'y': 2036.0, 'width': 680.0, 'x': 792.0, 'height': 489.0}, 'label': 'Object'}]"
277,IMG_7003.jpg,1,tip,442,1037,1951,2386,435,595,739,2168,"[{'type': 'rectangle', 'coordinates': {'y': 2168.0, 'width': 595.0, 'x': 739.0, 'height': 435.0}, 'label': 'Object'}]"
278,IMG_6876.jpg,1,tip,746,1147,1924,2403,479,401,946,2163,"[{'type': 'rectangle', 'coordinates': {'y': 2163.0, 'width': 401.0, 'x': 946.0, 'height': 479.0}, 'label': 'Object'}]"
279,IMG_6862.jpg,1,tip,1340,1599,2342,2638,296,259,1469,2490,"[{'type': 'rectangle', 'coordinates': {'y': 2490.0, 'width': 259.0, 'x': 1469.0, 'height': 296.0}, 'label': 'Object'}]"
280,IMG_6889.jpg,1,tip,469,890,2240,2658,418,421,679,2449,"[{'type': 'rectangle', 'coordinates': {'y': 2449.0, 'width': 421.0, 'x': 679.0, 'height': 418.0}, 'label': 'Object'}]"
281,IMG_6902.jpg,1,tip,298,704,2531,2980,449,406,501,2755,"[{'type': 'rectangle', 'coordinates': {'y': 2755.0, 'width': 406.0, 'x': 501.0, 'height': 449.0}, 'label': 'Object'}]"
282,IMG_6916.jpg,1,tip,572,907,2081,2350,269,335,739,2215,"[{'type': 'rectangle', 'coordinates': {'y': 2215.0, 'width': 335.0, 'x': 739.0, 'height': 269.0}, 'label': 'Object'}]"
283,IMG_6917.jpg,1,tip,489,836,2051,2286,235,347,662,2168,"[{'type': 'rectangle', 'coordinates': {'y': 2168.0, 'width': 347.0, 'x': 662.0, 'height': 235.0}, 'label': 'Object'}]"
284,IMG_6903.jpg,1,tip,315,731,2597,3051,454,416,523,2824,"[{'type': 'rectangle', 'coordinates': {'y': 2824.0, 'width': 416.0, 'x': 523.0, 'height': 454.0}, 'label': 'Object'}]"
285,IMG_6888.jpg,1,tip,438,912,2244,2687,443,474,675,2465,"[{'type': 'rectangle', 'coordinates': {'y': 2465.0, 'width': 474.0, 'x': 675.0, 'height': 443.0}, 'label': 'Object'}]"
286,IMG_6863.jpg,1,tip,1281,1552,2222,2511,289,271,1416,2366,"[{'type': 'rectangle', 'coordinates': {'y': 2366.0, 'width': 271.0, 'x': 1416.0, 'height': 289.0}, 'label': 'Object'}]"
287,IMG_6877.jpg,1,tip,560,963,2068,2548,480,403,761,2308,"[{'type': 'rectangle', 'coordinates': {'y': 2308.0, 'width': 403.0, 'x': 761.0, 'height': 480.0}, 'label': 'Object'}]"
288,IMG_7002.jpg,1,tip,352,988,1822,2308,486,636,670,2065,"[{'type': 'rectangle', 'coordinates': {'y': 2065.0, 'width': 636.0, 'x': 670.0, 'height': 486.0}, 'label': 'Object'}]"
289,IMG_7016.jpg,1,tip,878,1371,1061,1538,477,493,1124,1299,"[{'type': 'rectangle', 'coordinates': {'y': 1299.0, 'width': 493.0, 'x': 1124.0, 'height': 477.0}, 'label': 'Object'}]"
290,IMG_7012.jpg,1,tip,2,369,934,1394,460,367,185,1164,"[{'type': 'rectangle', 'coordinates': {'y': 1164.0, 'width': 367.0, 'x': 185.0, 'height': 460.0}, 'label': 'Object'}]"
291,IMG_7006.jpg,1,tip,315,667,1367,1822,455,352,491,1594,"[{'type': 'rectangle', 'coordinates': {'y': 1594.0, 'width': 352.0, 'x': 491.0, 'height': 455.0}, 'label': 'Object'}]"
292,IMG_6873.jpg,1,tip,748,1186,2137,2675,538,438,967,2406,"[{'type': 'rectangle', 'coordinates': {'y': 2406.0, 'width': 438.0, 'x': 967.0, 'height': 538.0}, 'label': 'Object'}]"
293,IMG_6867.jpg,1,tip,1560,1980,2506,3039,533,420,1770,2772,"[{'type': 'rectangle', 'coordinates': {'y': 2772.0, 'width': 420.0, 'x': 1770.0, 'height': 533.0}, 'label': 'Object'}]"
294,IMG_6898.jpg,1,tip,210,589,2362,2773,411,379,399,2567,"[{'type': 'rectangle', 'coordinates': {'y': 2567.0, 'width': 379.0, 'x': 399.0, 'height': 411.0}, 'label': 'Object'}]"
295,IMG_6907.jpg,1,tip,606,1034,1408,1848,440,428,820,1628,"[{'type': 'rectangle', 'coordinates': {'y': 1628.0, 'width': 428.0, 'x': 820.0, 'height': 440.0}, 'label': 'Object'}]"
296,IMG_6913.jpg,1,tip,731,1083,2034,2262,228,352,907,2148,"[{'type': 'rectangle', 'coordinates': {'y': 2148.0, 'width': 352.0, 'x': 907.0, 'height': 228.0}, 'label': 'Object'}]"
297,IMG_6912.jpg,1,tip,802,1159,2100,2342,242,357,980,2221,"[{'type': 'rectangle', 'coordinates': {'y': 2221.0, 'width': 357.0, 'x': 980.0, 'height': 242.0}, 'label': 'Object'}]"
298,IMG_6906.jpg,1,tip,638,1041,1538,1971,433,403,839,1754,"[{'type': 'rectangle', 'coordinates': {'y': 1754.0, 'width': 403.0, 'x': 839.0, 'height': 433.0}, 'label': 'Object'}]"
299,IMG_6899.jpg,1,tip,193,557,2433,2841,408,364,375,2637,"[{'type': 'rectangle', 'coordinates': {'y': 2637.0, 'width': 364.0, 'x': 375.0, 'height': 408.0}, 'label': 'Object'}]"
300,IMG_6866.jpg,1,tip,1107,1430,2288,2692,404,323,1268,2490,"[{'type': 'rectangle', 'coordinates': {'y': 2490.0, 'width': 323.0, 'x': 1268.0, 'height': 404.0}, 'label': 'Object'}]"
301,IMG_6872.jpg,1,tip,1076,1506,2433,2934,501,430,1291,2683,"[{'type': 'rectangle', 'coordinates': {'y': 2683.0, 'width': 430.0, 'x': 1291.0, 'height': 501.0}, 'label': 'Object'}]"
302,IMG_7007.jpg,1,tip,438,936,1474,1932,458,498,687,1703,"[{'type': 'rectangle', 'coordinates': {'y': 1703.0, 'width': 498.0, 'x': 687.0, 'height': 458.0}, 'label': 'Object'}]"
303,IMG_7005.jpg,1,tip,191,535,1465,1868,403,344,363,1666,"[{'type': 'rectangle', 'coordinates': {'y': 1666.0, 'width': 344.0, 'x': 363.0, 'height': 403.0}, 'label': 'Object'}]"
304,IMG_7011.jpg,1,tip,34,416,1254,1680,426,382,225,1467,"[{'type': 'rectangle', 'coordinates': {'y': 1467.0, 'width': 382.0, 'x': 225.0, 'height': 426.0}, 'label': 'Object'}]"
305,IMG_6864.jpg,1,tip,1279,1547,2249,2540,291,268,1413,2394,"[{'type': 'rectangle', 'coordinates': {'y': 2394.0, 'width': 268.0, 'x': 1413.0, 'height': 291.0}, 'label': 'Object'}]"
306,IMG_6870.jpg,1,tip,1252,1728,2560,3056,496,476,1490,2808,"[{'type': 'rectangle', 'coordinates': {'y': 2808.0, 'width': 476.0, 'x': 1490.0, 'height': 496.0}, 'label': 'Object'}]"
307,IMG_6858.jpg,1,tip,626,1044,1064,1489,425,418,835,1276,"[{'type': 'rectangle', 'coordinates': {'y': 1276.0, 'width': 418.0, 'x': 835.0, 'height': 425.0}, 'label': 'Object'}]"
308,IMG_6910.jpg,1,tip,562,988,1496,1932,436,426,775,1714,"[{'type': 'rectangle', 'coordinates': {'y': 1714.0, 'width': 426.0, 'x': 775.0, 'height': 436.0}, 'label': 'Object'}]"
309,IMG_6904.jpg,1,tip,362,831,2641,3076,435,469,596,2858,"[{'type': 'rectangle', 'coordinates': {'y': 2858.0, 'width': 469.0, 'x': 596.0, 'height': 435.0}, 'label': 'Object'}]"
310,IMG_6938.jpg,1,tip,523,922,1636,2012,376,399,722,1824,"[{'type': 'rectangle', 'coordinates': {'y': 1824.0, 'width': 399.0, 'x': 722.0, 'height': 376.0}, 'label': 'Object'}]"
311,IMG_6939.jpg,1,tip,489,875,1562,1968,406,386,682,1765,"[{'type': 'rectangle', 'coordinates': {'y': 1765.0, 'width': 386.0, 'x': 682.0, 'height': 406.0}, 'label': 'Object'}]"
312,IMG_6905.jpg,1,tip,313,856,2650,3064,414,543,584,2857,"[{'type': 'rectangle', 'coordinates': {'y': 2857.0, 'width': 543.0, 'x': 584.0, 'height': 414.0}, 'label': 'Object'}]"
313,IMG_6911.jpg,1,tip,562,973,1538,1966,428,411,767,1752,"[{'type': 'rectangle', 'coordinates': {'y': 1752.0, 'width': 411.0, 'x': 767.0, 'height': 428.0}, 'label': 'Object'}]"
314,IMG_6859.jpg,1,tip,447,1032,1802,2203,401,585,739,2002,"[{'type': 'rectangle', 'coordinates': {'y': 2002.0, 'width': 585.0, 'x': 739.0, 'height': 401.0}, 'label': 'Object'}]"
315,IMG_6871.jpg,1,tip,1151,1631,2555,3056,501,480,1391,2805,"[{'type': 'rectangle', 'coordinates': {'y': 2805.0, 'width': 480.0, 'x': 1391.0, 'height': 501.0}, 'label': 'Object'}]"
316,IMG_6865.jpg,1,tip,1169,1479,2328,2636,308,310,1324,2482,"[{'type': 'rectangle', 'coordinates': {'y': 2482.0, 'width': 310.0, 'x': 1324.0, 'height': 308.0}, 'label': 'Object'}]"
317,IMG_7010.jpg,1,tip,78,530,1401,1839,438,452,304,1620,"[{'type': 'rectangle', 'coordinates': {'y': 1620.0, 'width': 452.0, 'x': 304.0, 'height': 438.0}, 'label': 'Object'}]"
318,IMG_7004.jpg,1,tip,139,533,1628,2078,450,394,336,1853,"[{'type': 'rectangle', 'coordinates': {'y': 1853.0, 'width': 394.0, 'x': 336.0, 'height': 450.0}, 'label': 'Object'}]"